
 > Momo & Momo presents:
`````````````````````````````````````````````````````````````````````
```██████╗`██╗```██╗███╗```██╗`██████╗`███████╗`██████╗`███╗```██╗```
```██╔══██╗██║```██║████╗``██║██╔════╝`██╔════╝██╔═══██╗████╗``██║```
```██║``██║██║```██║██╔██╗`██║██║``███╗█████╗``██║```██║██╔██╗`██║```
```██║``██║██║```██║██║╚██╗██║██║```██║██╔══╝``██║```██║██║╚██╗██║```
```██████╔╝╚██████╔╝██║`╚████║╚██████╔╝███████╗╚██████╔╝██║`╚████║```
```╚═════╝``╚═════╝`╚═╝``╚═══╝`╚═════╝`╚══════╝`╚═════╝`╚═╝``╚═══╝```
`````````````````````````````````````````````````````````````````````
`````````██╗````██╗`█████╗`██╗`````██╗``██╗███████╗██████╗```````````
`````````██║````██║██╔══██╗██║`````██║`██╔╝██╔════╝██╔══██╗``````````
`````````██║`█╗`██║███████║██║`````█████╔╝`█████╗``██████╔╝``````````
`````````██║███╗██║██╔══██║██║`````██╔═██╗`██╔══╝``██╔══██╗``````````
`````````╚███╔███╔╝██║``██║███████╗██║``██╗███████╗██║``██║``````````
``````````╚══╝╚══╝`╚═╝``╚═╝╚══════╝╚═╝``╚═╝╚══════╝╚═╝``╚═╝``````````
`````````````````````````````````````````````````````````````````````
-`-`-`-`-`-`-`-`-`-`-`::``E.N.G.I.N.E``::`-`-`-`-`-`-`-`-`-`-`-`-`-`-
-```````````````````````````````````````````````````````````````````-
